111111111111111111
1P000000000C000001
101111111111111101
1000000000C0000001
101111111111111111
10000000C0000000E1
111111111111111111