11111111111111111111111111
10000000000000000000000011
11111111100000000110000011
1000000001111100C0000P0011
10000000000000111110010011
10E0000C0A00C00000000A0011
11111111111111111111111111