11111111111111111111111111
1000000000C0000000000C0001
1P00000000A000000C000000E1
11111111111111111111111111