1111111111111111111111111
10E0000C00000000000000001
1111111110000000000000001
10000000011111000C0000001
1000000000000011111000001
100P000C0000000000000C001
1111111111111111111111111