1111111111111111111111111
10E0000000000000000000001
1111111110000000000000001
10000000011111000C0000001
1000000000000011111000001
100000000000000000P00C001
1111111111111111111111111