1111111111111111111111111
1000000000000000000000001
1111111110000000011000001
1000000001111100C0000P0o1
1000000000000011111001001
10E0000C0A00C00000000A001
1111111111111111111111111