1111111111111111111111111
100000000000000000P0A0001
1111111110000000011000001
1000000001111100C000000o1
1000000000000011111000001
10E0000C0000C00000000C001
1111111111111111111111111