11111111111111111111111111
10000000000000000000000011
11111111100000000110000011
1000000001111100C0000P0011
10000000000000110000000011
10E0000C0A00C0000000000011
11111111111111111111111111