111111111111111111111111
10000000000000000000C0E1
100000000000000000011111
10000000A0000000000000C1
101111111111111111111111
100000000000000000000001
11111111000C0000000000C1
100000001111110000011111
1C00A0000000000000000P01
111111111111111111111111