11111111111111111111111111111111111111111111111111111
10000000000000000000C0E111111111111111111111111111111
10000000000000000001111111111111111111111111111111111
10000000A0000000000000C111111111111111111111111111111
10111111111111111111111111111111111111111111111111111
10000000000000000000000111111111111111111111111111111
11111111000C0000000000C111111111111111111111111111111
10000000111111000001111111111111111111111111111111111
1C00A0000000000000000P0111111111111111111111111111111
11111111111111111111111111111111111111111111111111111