11111111
10P0C0E1
111111111
1