1111111111111111
1000000000000001
1000000000000001
1001111111111111
1010000000000001
1000000000000001
1111111111111001
1000000000000101
1P00000000000001
1111111111111111